

NO ./textures/0.xpm
SO ./textures/00.xpm
WE ./textures/000.xpm
EA /home/hfazaz/cub3d/textures/0000.xpm


 
F    220 ,         100       ,   0        
C      225      ,       30   ,   0















11
101      11111111111111111111111111
1101     1000000000110000000000001
111     1011000001110000000000001
        1001000000000000000000001
111111111011000001110000000000001
10000000S011000001110111111111111
11110111111111011100000010001
11110111111111011101010010001
11000000110101011100000010001
10000000000000001100000010001
10000000000000001101010010001
1100000111010101111101111000111
11110111 1110101 101111010001
11111111 1111111 111111111111
