NO ./textures/0.xpm
SO ./textures/00.xpm
WE ./textures/000.xpm
EA ./textures/0000.xpm
EA ./textures/0000.xpm



 
F 139,99,58
C 135,206,235


1111111111111111111
1N001001001001001001
1001001001001001001
1001001001001001001
1001001000001001001
100000000000000001
1000011111111000001
1111000000000001111
1000000101010000001
1111111111111111111

