NO ./textures/b.xpm
SO ./textures/b.xpm
EA ./textures/b.xpm
WE ./textures/b.xpm


F 171, 91, 38
C 112, 192, 207

   11111111111111111111111111111111111111111    1
11110000000S0000000000000000000000000001
1011110111110111111111011111111111111101
101001010001010000000101000000000000010
1010010100010111111101010111111111110101
1010010100010000000101010100000000010101
1011110111111111110101010101111111010101
10000000010000000001 01010101000001010101
1111111111111111111101010101011101010101
1000000000000000000001010101010101010101
1011111111111111111111010101000101010101
1010000000000000000000010101010101010101
1010111111111111111111110101010101010101
1010100000000000000000000001010101000101
1010001111111111111111111101010101010001
1010101000000000000000000001010101010101
1010101011111111111111111111010101010101
1010101010000000000000000000010101010101
1000101010111111111111111111110101010101
1010101000100000000000000000000101010101
101010101010111111111111111111101010101
1111111111111111111111111111111111111111