NO textures/b.xpm
SO textures/b.xpm
WE textures/b.xpm
EA textures/b.xpm

F 20,20,20
C 200,200,200

11111
111S1
11111 111
